MGGGGMGAGGGGGGGGMMMMMMMGGGMMMMMGGGGMMMGGGG
MGMMMMGAGMMMMGGMMMMMMMMMGGMGGGMGGMMMMMMMGG
MGGGGMGAGMGGMGMMMMMMMMMMMGMMGMMGMMMMLMMMMG
MGMMMMGAGMGGMGMMMMMMMMMMMGGMGMGMMMMLLLMMMM
MGGGGMGAGGGGGGGMMMMMMMMMGGGMGMGMMMLLLLLMMM
MMMMGMGAAAAAGGGGGMMMMMGGGMGMGMGMMMMLLLMMMM
GMGGGGGGGGGAGMMGGGGGGGGGGMGMGMGGMMMMLMMMMG
GMGGGGMMMMGAGMMGGGGMGGMGGGGGGGGGGMMMMMMMGG
GGGGMGGGGGGGGGGGGGMMMGGGMMMMMMMGGGGMMMGGGG
GGMGGGGGMMGAGMMGMGGMGGGGGGGGGGGGGGGGGGGGMG
GGMGMMMGMMGAGMMGMGGGGGGGMMMGGGMMMGMMMMGGMG
GGMGGGGGGGGAGGGGMMMMMGGMMMMMGGMMMGGGGGGGGG
GGMGGGGGGGGAAAAGMGGMGGMMMMMMMGGGGGMGGMMMMG
GGGGGGGGMGGGGGAGMGGMGGMMMAMMMGGGGGMGGGGGGG
MMMMGMGMMMGGGGAGGGGMGGGMMAMMGGGGMMMMMMMGGG
GGGGGMGMMMGGAAAAAGGMGGGGGAGGGGGGGGGMGGGGGG
GGMGGMGGMGGAAAAAAAGGGMMMGAGGGMGGMGGMGGGGGG
MGMGGMGGGGAAAAAAAAAGGGGGGAGMMMMGMGGMGGGGMM
MGMGGMGGGGAAAGGGAAAGGMGGGAGGGMGGMGGGGMMMMM
MGMGMMMGGGAAAGGGAAAGMMMGGAGGGGGGMMMGMMMMMM
MGGGGGGGGGAAAGGGAAAGMMMGGAAAAAAGGGGGGGGGMM
MMMMMGGGGGAAAAAAAAAGMMMGGGGGGGAGMMMGMMMMMM
GGGGMGMGGGGAAAAAAAGGGMGGGMMMGGAGMGGGGMMMMM
GGGGMGMGGGGGAAAAAGGGGGGGGMMMGGAGMGMMGGGGMM
GGMGGGMGMMGGGGAGGGGGGMMMGGGGGGAGMGMGGGGGGG
GMMMGGMGMMMMGGAGGGMMGGGGGGMGGGAGGGMMMMGGGG
GMMMGMMGGGGGGGAGGMMMMGGGMGMGGAAAGGGMMMGGMG
GMMMGGGGMMMGGGAGMMMMMMGGMGGGAAAAAGGGGGGGMG
GGMGGGGGGGGGGGAGMMMMMMGGMGGAAAAAAAGGMMMMMG
MGGGMGGMAAAAAAAGGMMMMGGGMGGGAAAAAGGGMGGGMG
MMGMMMGGAGGGGGMGGGMMGGMMMMGGGAAAGGGGGGGGGG
MMGMMMGGAGGGGGMGMGGGGGGGGGGGGGGGGMMMMGMMMG
MGGGMGGGAGMMMMMGMMMMGMMMMMMGGGGMGGGMGGGMGG
GGGGGGGGGGGGGGGGGGGGGGGGGGMGGMMMMMGMGMGMGM
GMGMMMMGAGMMMGMMMMMMMMMMGMMGGGGGGGGGGGGMGM
GMGGGGMGAGGMGGMGGGGGGGGMGMGGMMMMCMMMMGGMGM
GMMMGGMGAGGMGGMGMMMMMMGMGGGMMMLLCLLMMMGGGM
GMGGGGMGAGGGGGMGMGGGGMGMGGMMLLLLCLLLLMMGGM
MMGMMMMGAAAAGGMGGGGGGMGMGGMMLLLLCLLLLMMGGG
MGGGGGMGGGGAGGMMMMMMMMGMGMMLLLLLCLLLLLMMGG
MGMMMGMGGGGAGGGGGGGGGGGGGMMLLLLLCLLLLLMMGG
MGGGGGMGGGGAGGMMMMMMMMMMGMMLLLLLLLLLLLMMGG